**********
**********
**********
**********
*********S
*******---
*******-**
*******-**
***-----**
***E******

