**********
**********
**********
**********
**********
**********
**********
***---****
***-*-****
***S*E****

