****S*****
****-*****
***--*****
***-******
E---******
**********
**********
**********
**********
**********

