**********
**********
**********
********-S
********-*
******---*
******-***
******---E
**********
**********

