**********
**********
**********
**********
********-S
***------*
***-******
***-******
E---******
**********

