****S*****
****-*****
****-*****
****-*****
****-*****
****-*****
****-*****
****----**
*******-**
*******--E

