**********
**********
**********
E--*******
**-*******
**-*******
**-------S
**********
**********
**********

