*****S****
*****----E
**********
**********
**********
**********
**********
**********
**********
**********

