********S*
********-*
********-*
********-*
********-*
********-*
********-E
**********
**********
**********

