**********
**********
S--*******
**-*******
**-*******
**-*******
**-------E
**********
**********
**********

