**********
********-S
****---*-*
****-*-*-*
****-*---*
E----*****
**********
**********
**********
**********

