***S-*****
****-*****
****-*****
****-*****
****-----E
**********
**********
**********
**********
**********

