S*********
-*********
---*******
**-*******
**----****
*****-****
*****----E
**********
**********
**********

