***-S*****
***-******
***-******
***-******
E---******
**********
**********
**********
**********
**********

