*******E**
--------**
-*********
S*********
**********
**********
**********
**********
**********
**********

