**********
**********
**********
**********
S-********
*-********
*------***
******-*-E
******-*-*
******---*

