******S***
******-***
****---***
****-*****
****-----E
**********
**********
**********
**********
**********

