**********
**********
**********
**********
***---****
***-*-****
***-*-****
***-*----E
***-******
***S******
